111
1001
10P01
100001
1C0E001
10000001
111110111

