11111111111
1000000C001
10P0000001
100000000E1
11111111111
